MMMMMMMMMMMMMMMMMMMMMMMMMMMMMMMMMMMMMMMM
MGGGGGGGGGGGGGGGGWWWGGGGGGGGGGGGGGGGGGGM
MGGGGGGGGGGGGGGGGWWWGGGGGGGGGGGGGGGGGGGM
MGGGG.GGGGGGGGGGGWWWGGGGGGGGGGGGGGGGGGGM
MGGGGGGGGGGGGGGGGWWWGGGGGGGGGGGGGGGGGGGM
MGGGGGGGGGGGGGGGGWWWWGGGGGGGGGGGGGGGGGGM
MGGGGGGGGGGGGGGGGGWWWGGGGGGGGGGGGGGGGGGM
MGGGGGGGGGGGGGGGGGWWWGGGGGGGGGGGGGGGGGGM
MGGGGGGGGGGGGGGGGGGWWWGGGGGGGGGGGGGGGGGM
MGGGGGGGGGGGGGGGGGGWWWGGGGGGGGGGGGGGGGGM
MGGGGGGGGGGGGGGGGGGGWWWGGGGGGGGGGGGGGGGM
MGGGGGGGGGGGGGGGGGGGGWWWGGGGGGGGGGGGGGGM
MGGGGGGGGGGGGGGGGGGGGGWWWWGGGGGGGGGGGGGM
MGGGGGGGGGMMGGGGGGGGGGGGWWWWGGGGGGGGGGGM
MGGGGGGGGMMMGGGGGGGGGGGGGGWWWWGGGGGGGGGM
MGGGGGGGGMMMMGGGGGGGGGGGGGGGWWWWGGGGGGGM
MGGGGGGGGMMMMGGGGGGGGGGGGGGGGGWWWWGGGGGM
MGGGGGGGGMMMMGGGGGGGGGGGGGGGGGGGGGGGGGGM
MGGGGGGGGGMMMGGGGGGGGGGGGGGGGGGGGGGGGGGM
MGGGGGGGGGMMGGGGGGGGGGGGGGGGGGGGGGGGGGGM
MGGGGGGGGGGGGGGGGGGGGGGGGGGGGGGGGGGGGGGM
MGGGGGGGGGGGGGGGGGGGGGGGGGGGGGGGGGGGGGGM
MGGGGGGGGGGGGGGGGGGGGGGGGGGGGGGGGGGGGGGM
MGGGGGGGGGGGGGGGGGGGGGGGGGGGGGGGGGGGGMMM
MGGGGGGGGGGGGGGGGGGGGGGGGGGGGGGGGMMMMMMM
MGGGGGGGGGGWWWWGGGGGGGGGGGGGGGMMMMMMMMMM
MGGGGGGGGWWWWWWWWGGGGGGGGGGGGGMMMMMMMMMM
MGGGGGGGWWWWWWWWWWGGGGGGGGGGGGMMMMMMMMMM
MGGGGGGGWWWWWWWWWWGGGGGGGGGGGGGGMMMMMMMM
MGGGGGGGGGWWWWWWWGGGGGGGGGGGGGGGGGMMMMMM
MGGGGGGGGGGGWWWWGGGGGGGGGGGGGGGGGGGGMMMM
MGGGGGGGGGGGGGGGGGGGGGGGGGGGGGGGGGGGMMMM
MGGGGGGGGGGGGGGGGGGGGGGGGG,GGGGGGGGMMMMM
MGGGGGGGGGGGGGGGGGGGGGGGGGGGGGGGGGGMMMMM
MGGGGGGGGGGGGGGGGGGGGGGGGGGGGGGGGGMMMMMM
MGGGGGGGGGGGGGGGGGGGGGGGGGGGGGGMMMMMMMMM
MGGGGGGGGGGGGGGGGGGGGGGGGGGGGMMMMMMMMMMM
MGGGGGGGGGGGGGGGGGGGGGGGGGGGMMMMMMMMMMMM
MGGGGGGGGGGGGGGGGGGGGGGGGGGGMMMMMMMMMMMM
MMMMMMMMMMMMMMMMMMMMMMMMMMMMMMMMMMMMMMMM