# this is a test comment

# this is a small map that is really frustrating to
# play and really even the game itself isn't that fun


MMMMMMMMMMMMMMMMMMMM
MMMGGGGGGGMMGGGGGGMM
MGG.GGGGGGGGGGGGGGMM
MGGGGWWGGGGGGGGGGGGM
MGGGWWWGGGGGGGGGGGGM
MGGGGWWWGGGGGGGMGGGM
MGGGGGGGGGGGGGMMGGGM
MGGGGGGGGGGGGGGGGGGM
MMGGGGGGGGGGMMGGGGGM
MMMGGGGGGGGMMMMGGGGM
MMGGGGGGGGGGMMGGGGGM
MGGGGGGGGGGGGG,GGGGM
MGGGGGGGGGGGGGGGGGGM
MMMMMMMMMMMMMMMMMMMM